####################
OXOp               #
OE##            P  #
O                  #    
#                  #	
#                  #
#                  #
#                p #
#     b    P b     #
######## #OO########
#        #O   P    #
#     #### ###     #
#         O#   #   #
#### ##   ##   # # #
#      # bP   O#####   
# P P  #     bOO   #
# b#####       O C #
#OO  p PO#########O#
#bO   C         POX#
####################