######bOP #OPOPOPOb#
#   E#OO#  P####O CX
# CC#####   #   ####
# C X  ##X C#  X b##
## #X# # X    CXC ##
#X   # # PC #C#X####
#b     ###  #   #OO#
######b#OO# #####OO#
#b   # #  # #     ##
#b   # #### #     ##
# p  # #### #     ##
# ####      ##### ##
OOP   ##pP##    POO#
OO#     OO      #OO#
OOO#   CPpC    #OOO#
OOOO#         #OOOO#
OOOOO# C   C #OOOOO#
OOOOOO#X   X#OOOOOO#
OOOOOOO#X X#OOOOOOO#     
bbbOOOOOOOOOOOOObbb#