####################
#         #b     OX#
# ####### #      #C#
# #   # # #      O #
# # # # # #p     # # 
# # # # # #  P   # #
# # # # #E#  p   # # 
# # #   ######   # # 
#   #bPO    p    # #
######O######   ## #
#       ####OOOOb# #
# ################ #
# #   POP         O#
# # # ### ##########
# # #      #       #
# # ######## ##### #
# #b         POCX# #
# ################ #
#          P      O#
####################