####################
#E ###   #   #  #Ob#
##  ## C      P  OX#
#X#  #   #   #  #Ob#
#C##  ###### #######
#b###  #####  ######
#O####  ##### #O#O##
#P#####  ###  ##O###
#O######  #  ##O#O##
#O#######   ########
#P#######   ###OOO##
#O##b     #  ##ObO##
#P P   p####  #OOO##
#O##    #####  #####
#P##    ######  ####
#O#############  ###
#P##############  ##
#                  #
####################
####################