##########
#   X   X#
#P  b    #
#   C   C#
#O       #
#X    p# #
# CCp  # #
#  X  O# #
#      #E#
##########
