####################
#   X   X# p    X  #
#P   b      P      #
#   C   C#O  C     #    
#O       #X        #	
#X    p# ###### #  #
# CC   # #  O  O#  #
#    XO# #  p   #C #
#   p  #E#         #
######## ## ########
#        ##    #   #
#     ######## #   #
#        ##    #   #
#### ###  #    p   #
#      #   #       #   
#       #   #      #
#  ######    #  O  #
#O      P #  #  P  #
#bO                #
####################