####################
#   X   X# p    X  #
#P   b      P      #
#   C   C#O  C     #    
#O       #X        #	
#X    p# ###### #  #
# CC   # #  O  O#  #
#    XO# #  p   #C #
#   p  #E#         #
######## ## ########
#        ##    #   #
#     ######## #   #
#         #    #   #
#### ##   #   bp   #
#b     #   ###     #   
#    C #     #     #
#P     ## #  #  O  #
#O OO    P#     P  #
#bOXO     #  #     #
####################