##########
#b  X   X#
#P       #
#   C   C#
#O       #
#X    p# #
# CC   # #
#     O# #
#X  p  #E#
##########
